1 1 1 1 1 1 1 1 1 1 1 1 1 5 52 52 52 52 52 52 52 52 52 52 52 52 52 52 52 52 52 52 52 52 52 52 52 52 52 52 52 52 52 52 52 52 52 52 52 52
1 0 0 0 0 0 0 0 0 0 0 0 1 5 52 52 52 52 34 32 32 32 32 32 32 32 32 32 32 32 32 52 52 52 52 52 52 52 52 52 52 52 52 52 52 52 52 52 52 52
1 0 15 12 12 12 10 12 12 12 17 0 1 5 52 52 52 52 34 32 32 32 32 32 32 32 32 32 32 32 32 52 52 52 52 52 52 52 52 52 52 52 52 52 52 52 52 52 52 52
1 0 15 12 26 2 14 2 25 12 17 0 1 5 52 52 52 52 40 43 43 43 43 43 43 43 43 43 41 32 32 0 9 0 9 0 9 0 0 9 0 9 0 0 9 0 9 0 0 0
1 0 21 23 4 29 8 30 24 31 22 0 1 5 52 52 52 52 34 32 32 32 32 32 32 32 32 32 44 32 32 0 9 0 9 0 9 0 0 9 0 9 0 0 9 0 9 0 0 0
1 0 18 13 27 2 14 2 28 13 20 0 1 5 52 52 52 52 34 32 32 32 32 32 32 32 32 32 44 32 32 0 9 0 9 0 9 0 0 9 0 9 0 0 9 0 9 0 0 0
1 0 18 13 13 13 11 13 13 13 20 0 1 5 52 52 52 52 34 32 32 32 32 32 32 32 32 32 44 32 32 0 9 0 9 0 9 0 0 9 0 9 0 0 9 0 9 0 0 0
1 0 0 0 0 0 0 0 0 0 0 0 0 0 52 52 52 52 34 32 32 32 32 32 32 32 32 32 44 32 32 0 9 0 9 0 9 0 0 9 0 9 0 0 9 0 9 0 0 0
1 0 15 12 12 12 10 12 12 12 17 0 1 5 52 52 52 52 34 32 32 32 32 39 32 32 32 32 44 32 32 0 9 0 9 0 9 0 0 0 1 1 1 0 0 1 1 1 0 0
1 0 15 12 26 2 14 2 25 12 17 0 1 5 52 52 52 52 34 32 32 32 32 32 32 32 32 32 44 32 32 0 9 0 9 0 9 0 0 9 1 9 0 0 0 0 9 1 0 0
1 0 21 23 4 29 8 30 24 31 22 0 1 5 52 52 52 52 34 32 32 32 32 32 32 32 32 32 44 32 32 0 9 0 9 0 9 0 0 9 1 9 0 0 0 0 9 1 0 0
1 0 18 13 27 2 14 2 28 13 20 0 1 5 52 52 52 52 34 32 32 32 32 32 32 32 32 32 44 32 32 0 9 0 9 0 9 0 0 9 1 9 0 0 0 0 9 1 0 0
1 0 18 13 13 13 11 13 13 13 20 0 1 5 52 52 52 52 36 37 32 32 32 32 32 32 32 32 44 32 32 0 0 0 9 0 9 0 0 9 1 9 0 0 0 0 9 1 0 0
1 0 0 0 0 0 0 0 0 0 0 0 1 5 52 52 52 52 38 35 33 33 33 33 33 33 33 33 42 33 33 0 0 0 0 0 9 0 0 9 1 9 0 0 0 0 9 1 0 0
3 3 3 3 3 3 3 3 3 3 3 3 3 0 0 0 9 0 9 0 9 0 9 0 0 9 0 9 0 0 9 0 9 0 9 0 9 0 0 9 3 3 3 0 0 3 3 3 5 0
1 7 7 7 7 7 7 7 58 0 0 0 1 0 0 0 9 0 9 0 9 0 9 0 0 9 0 9 0 0 9 0 9 0 9 0 0 0 0 58 7 7 7 7 7 7 7 1 5 0
1 6 6 6 6 6 6 6 0 0 0 0 0 0 0 0 9 0 9 0 9 0 9 0 0 9 0 9 0 0 9 0 9 0 9 0 9 0 0 0 6 6 6 6 6 6 6 1 5 0
1 0 45 0 48 0 47 0 1 0 0 0 1 52 52 52 52 52 52 52 52 52 52 52 52 52 52 52 52 52 52 52 52 52 52 1 0 0 0 1 0 49 0 45 0 45 0 1 5 0
1 0 46 0 49 0 46 0 1 0 0 0 1 52 52 52 52 52 52 52 52 52 52 52 52 52 52 52 52 52 52 52 52 52 52 1 0 0 0 1 0 51 0 50 0 45 0 1 5 0
1 0 47 0 50 0 45 0 1 0 0 0 1 52 52 52 52 52 52 52 52 52 52 52 52 52 52 52 52 52 52 52 52 52 52 1 0 0 0 1 0 49 0 46 0 50 0 1 5 0
1 0 48 0 51 0 48 0 1 0 0 0 1 52 52 52 52 52 52 52 52 52 52 52 52 52 52 52 52 52 52 52 52 52 52 1 0 0 0 1 0 48 0 50 0 46 0 1 5 0
1 0 49 0 50 0 50 0 1 0 0 0 1 52 52 52 52 52 52 52 52 52 52 52 52 52 52 52 52 52 52 52 52 52 52 1 0 0 0 1 0 49 0 48 0 45 0 1 5 0
1 0 0 0 0 0 0 0 1 0 0 0 1 52 52 52 52 52 52 52 52 52 52 52 52 52 52 52 52 52 52 52 52 52 52 1 0 0 0 1 0 0 0 0 0 0 0 1 5 0
1 7 7 7 7 7 7 7 58 0 0 0 1 52 52 52 52 52 52 52 52 52 52 52 52 52 52 52 52 52 52 52 52 52 52 1 0 0 0 58 7 7 7 7 7 7 7 1 5 0
1 6 6 6 6 6 6 6 0 0 0 9 0 9 0 0 9 0 9 0 9 0 9 0 0 9 0 9 0 0 9 0 9 0 9 0 9 0 0 0 6 6 6 6 6 6 6 1 5 0
1 0 45 0 48 0 47 0 1 0 0 0 1 52 52 52 52 52 52 52 52 52 52 52 52 52 52 52 52 52 52 52 52 52 52 1 0 0 0 1 0 46 0 46 0 45 0 1 5 0
1 0 46 0 49 0 46 0 1 0 0 0 1 52 52 52 52 52 52 52 52 52 52 52 52 52 52 52 52 52 52 52 52 52 52 1 0 0 0 1 0 47 0 47 0 48 0 1 5 0
1 0 47 0 50 0 45 0 1 0 0 0 1 52 52 52 52 52 52 52 52 52 52 52 52 52 52 52 52 52 52 52 52 52 52 1 0 0 0 1 0 48 0 45 0 49 0 1 5 0
1 0 48 0 51 0 48 0 1 0 0 0 1 52 52 52 52 52 52 52 52 52 52 52 52 52 52 52 52 52 52 52 52 52 52 1 0 0 0 1 0 49 0 46 0 50 0 1 5 0
1 0 49 0 50 0 50 0 1 0 0 0 1 52 52 52 52 52 52 52 52 52 52 52 52 52 52 52 52 52 52 52 52 52 52 1 0 0 0 1 0 50 0 45 0 47 0 1 5 0
1 0 0 0 0 0 0 0 1 0 0 0 1 52 52 52 56 55 55 55 55 55 55 55 55 55 55 55 55 55 55 54 52 52 52 1 0 0 0 1 0 0 0 0 0 0 0 1 5 0
1 7 7 7 7 7 7 7 58 0 0 0 1 54 52 52 57 1 58 58 58 58 58 58 58 58 58 58 58 58 1 53 52 52 56 1 0 0 0 58 7 7 7 7 7 7 7 1 0 0
1 6 6 6 6 6 6 6 0 0 0 0 1 53 52 52 57 1 0 0 0 0 9 0 9 0 0 0 0 0 1 53 52 52 57 1 0 0 0 0 6 6 6 6 6 6 6 1 0 0
1 0 45 0 48 0 47 0 1 0 0 0 1 53 52 52 57 1 0 0 61 62 61 0 0 61 61 62 0 0 1 53 52 52 57 1 0 0 0 1 0 51 0 48 0 46 0 1 0 0
1 0 45 0 48 0 47 0 1 0 0 0 1 53 52 52 57 1 0 0 59 60 59 0 0 59 59 60 0 0 1 53 52 52 57 1 0 0 0 1 0 50 0 47 0 46 0 1 0 0
1 0 47 0 50 0 45 0 1 0 0 0 1 53 52 52 57 1 0 0 0 0 0 0 0 0 0 0 0 0 1 53 52 52 57 1 0 0 0 1 0 46 0 49 0 51 0 1 0 0
1 0 45 0 48 0 47 0 1 0 0 0 1 53 52 52 57 1 0 0 62 62 62 0 0 62 62 61 0 0 1 53 52 52 57 1 0 0 0 1 0 45 0 45 0 48 0 1 0 0
1 0 45 0 48 0 47 0 1 0 0 0 1 53 52 52 57 1 0 0 60 60 59 0 0 60 60 59 0 0 1 53 52 52 57 1 0 0 0 1 0 46 0 49 0 45 0 1 0 0
1 0 0 0 0 0 0 0 1 0 0 0 1 53 52 52 57 1 0 0 0 0 0 0 0 0 0 0 0 0 1 53 52 52 57 1 0 0 0 1 0 0 0 0 0 0 0 1 0 0
1 7 7 7 7 7 7 7 58 0 0 0 58 58 58 58 58 58 58 58 58 58 58 0 0 58 58 58 58 58 58 58 58 58 58 58 0 0 0 58 7 7 7 7 7 7 7 1 0 0
1 6 6 6 6 6 6 6 0 0 0 0 0 0 0 0 9 0 9 0 9 0 9 0 0 9 0 9 0 0 9 0 0 0 0 0 0 0 0 0 6 6 6 6 6 6 6 1 0 0
1 0 45 0 48 0 47 0 1 0 0 0 0 0 0 0 9 0 9 0 9 0 9 0 0 9 0 9 0 0 9 0 9 0 0 0 0 0 0 1 0 46 0 48 0 47 0 1 0 0
1 0 46 0 49 0 46 0 1 0 0 0 0 0 0 0 9 0 9 0 9 0 9 0 0 9 0 9 0 0 9 0 9 0 0 0 0 0 0 1 0 45 0 48 0 48 0 1 0 0
1 0 47 0 50 0 45 0 1 0 0 0 0 0 0 0 9 0 9 0 9 0 9 0 0 9 0 9 0 0 9 0 9 0 0 0 0 0 0 1 0 45 0 49 0 49 0 1 0 0
1 0 48 0 51 0 48 0 1 0 0 0 0 0 0 0 9 0 9 0 9 0 9 0 0 9 0 9 0 0 9 0 9 0 0 0 0 0 0 1 0 45 0 47 0 47 0 1 0 0
1 0 49 0 50 0 50 0 1 0 0 0 0 0 0 0 9 0 9 0 9 0 9 0 0 9 0 9 0 0 9 0 9 0 0 0 0 0 0 1 0 49 0 47 0 51 0 1 0 0
1 0 0 0 0 0 0 0 1 0 0 0 0 0 0 0 9 0 9 0 9 0 9 0 0 9 0 9 0 0 9 0 9 0 9 0 0 0 0 1 0 0 0 0 0 0 0 1 0 0
3 3 3 3 3 3 3 3 3 3 3 3 3 0 0 0 9 0 9 0 9 0 9 0 0 9 0 9 0 0 9 0 9 0 9 3 3 3 3 3 3 3 3 3 3 3 3 3 0 0
5 5 5 5 5 5 5 5 5 5 5 5 5 5 5 5 5 5 5 5 5 5 5 5 5 5 5 5 5 5 5 5 5 5 5 5 5 5 5 5 5 5 5 5 5 5 5 5 5 5
5 5 5 5 5 5 5 5 5 5 5 5 5 5 5 5 5 5 5 5 5 5 5 5 5 5 5 5 5 5 5 5 5 5 5 5 5 5 5 5 5 5 5 5 5 5 5 5 5 5