1 1 1 1 1 1 1 1 1 1 1 1 1 5 0 0 9 0 9 0 9 0 9 0 0 9 0 9 0 0 9 0 9 0 9 0 0 0 0 1 0 0 0 0 0 0 0 1 0 0
1 0 0 0 0 0 0 0 0 0 0 0 1 5 0 0 0 0 34 32 32 32 32 32 32 32 32 32 32 32 32 0 9 0 9 0 9 0 0 9 0 9 0 0 9 0 9 0 0 5
1 0 15 12 12 12 10 12 12 12 17 0 1 5 0 0 0 0 34 32 32 32 32 32 32 32 32 32 32 32 32 0 9 0 9 0 9 0 0 9 0 9 0 0 9 0 9 0 0 4
1 0 15 12 26 2 14 2 25 12 17 0 1 5 0 0 0 0 40 43 43 43 43 43 43 43 43 43 41 32 32 0 9 0 9 0 9 0 0 9 0 9 0 0 9 0 9 0 0 0
1 0 21 23 4 29 8 30 24 31 22 0 1 5 0 0 0 0 34 32 32 32 32 32 32 32 32 32 44 32 32 0 9 0 9 0 9 0 0 9 0 9 0 0 9 0 9 0 0 0
1 0 18 13 27 2 14 2 28 13 20 0 1 5 0 0 0 0 34 32 32 32 32 32 32 32 32 32 44 32 32 0 9 0 9 0 9 0 0 9 0 9 0 0 9 0 9 0 0 0
1 0 18 13 13 13 11 13 13 13 20 0 1 5 0 0 0 0 34 32 32 32 32 32 32 32 32 32 44 32 32 0 9 0 9 0 9 0 0 9 0 9 0 0 9 0 9 0 0 0
1 0 0 0 0 0 0 0 0 0 0 0 0 0 0 0 0 0 34 32 32 32 32 32 32 32 32 32 44 32 32 0 9 0 9 0 9 0 0 9 0 9 0 0 9 0 9 0 0 0
1 0 15 12 12 12 10 12 12 12 17 0 1 5 0 0 0 0 34 32 32 32 32 39 32 32 32 32 44 32 32 0 9 0 9 0 9 0 0 0 1 1 1 0 0 1 1 1 0 0
1 0 15 12 26 2 14 2 25 12 17 0 1 5 0 0 0 0 34 32 32 32 32 32 32 32 32 32 44 32 32 0 9 0 9 0 9 0 0 9 1 9 0 0 0 0 9 1 0 0
1 0 21 23 4 29 8 30 24 31 22 0 1 5 0 0 0 0 34 32 32 32 32 32 32 32 32 32 44 32 32 0 9 0 9 0 9 0 0 9 1 9 0 0 0 0 9 1 0 0
1 0 18 13 27 2 14 2 28 13 20 0 1 5 0 0 0 0 34 32 32 32 32 32 32 32 32 32 44 32 32 0 9 0 9 0 9 0 0 9 1 9 0 0 0 0 9 1 0 0
1 0 18 13 13 13 11 13 13 13 20 0 1 5 0 0 0 0 36 37 32 32 32 32 32 32 32 32 44 32 32 0 0 0 9 0 9 0 0 9 1 9 0 0 0 0 9 1 0 0
1 0 0 0 0 0 0 0 0 0 0 0 1 5 0 0 0 0 38 35 33 33 33 33 33 33 33 33 42 33 33 0 0 0 0 0 9 0 0 9 1 9 0 0 0 0 9 1 0 0
3 3 3 3 3 3 3 3 3 3 3 3 3 0 0 0 9 0 9 0 9 0 9 0 0 9 0 9 0 0 9 0 9 0 9 0 9 0 0 9 3 3 3 0 0 3 3 3 5 0
1 7 7 7 7 7 7 7 1 0 0 0 1 0 0 0 9 0 9 0 9 0 9 0 0 9 0 9 0 0 9 0 9 0 9 0 9 0 0 1 7 7 7 7 7 7 7 1 5 0
1 6 6 6 6 6 6 6 0 0 0 0 0 0 0 0 9 0 9 0 9 0 9 0 0 9 0 9 0 0 9 0 9 0 9 0 9 0 0 0 6 6 6 6 6 6 6 1 5 0
1 0 45 0 48 0 47 0 1 0 0 0 0 0 0 0 9 0 9 0 9 0 9 0 0 9 0 9 0 0 9 0 9 0 9 0 9 0 0 1 0 49 0 45 0 45 0 1 5 0
1 0 46 0 49 0 46 0 1 0 0 0 0 0 0 0 9 0 9 0 9 0 9 0 0 9 0 9 0 0 9 0 9 0 9 0 9 0 0 1 0 51 0 50 0 45 0 1 5 0
1 0 47 0 50 0 45 0 1 0 0 0 0 0 0 0 9 0 9 0 9 0 9 0 0 9 0 9 0 0 9 0 9 0 9 0 9 0 0 1 0 49 0 46 0 50 0 1 5 0
1 0 48 0 51 0 48 0 1 0 0 0 0 0 0 0 9 0 9 0 9 0 9 0 0 9 0 9 0 0 9 0 9 0 9 0 9 0 0 1 0 48 0 50 0 46 0 1 5 0
1 0 49 0 50 0 50 0 1 0 0 0 0 0 0 0 9 0 9 0 9 0 9 0 0 9 0 9 0 0 9 0 9 0 9 0 9 0 0 1 0 49 0 48 0 45 0 1 5 0
1 0 0 0 0 0 0 0 1 0 0 0 1 0 0 0 9 0 9 0 9 0 9 0 0 9 0 9 0 0 9 0 9 0 9 0 9 0 0 1 0 0 0 0 0 0 0 1 5 0
1 7 7 7 7 7 7 7 1 0 0 9 0 9 0 0 9 0 9 0 9 0 9 0 0 9 0 9 0 0 9 0 9 0 9 0 9 0 0 1 7 7 7 7 7 7 7 1 5 0
1 6 6 6 6 6 6 6 0 0 0 9 0 9 0 0 9 0 9 0 9 0 9 0 0 9 0 9 0 0 9 0 9 0 9 0 9 0 0 0 6 6 6 6 6 6 6 1 5 0
1 0 45 0 48 0 47 0 1 0 0 0 1 9 0 0 9 0 9 0 9 0 9 0 0 9 0 9 0 0 9 0 9 0 9 0 9 0 0 1 0 46 0 46 0 45 0 1 5 0
1 0 46 0 49 0 46 0 1 0 0 0 1 9 0 0 9 0 9 0 9 0 9 0 0 9 0 9 0 0 9 0 9 0 9 0 9 0 0 1 0 47 0 47 0 48 0 1 5 0
1 0 47 0 50 0 45 0 1 0 0 0 1 9 0 0 9 0 9 0 9 0 9 0 0 9 0 9 0 0 9 0 9 0 9 0 9 0 0 1 0 48 0 45 0 49 0 1 5 0
1 0 48 0 51 0 48 0 1 0 0 0 1 9 0 0 9 0 9 0 9 0 9 0 0 9 0 9 0 0 9 0 9 0 9 0 9 0 0 1 0 49 0 46 0 50 0 1 5 0
1 0 49 0 50 0 50 0 1 0 0 0 1 9 0 0 9 0 9 0 9 0 9 0 0 9 0 9 0 0 9 0 9 0 9 0 9 0 0 1 0 50 0 45 0 47 0 1 5 0
1 0 0 0 0 0 0 0 1 0 0 0 1 0 0 0 5 5 5 5 5 5 5 5 5 5 5 5 5 5 5 5 0 0 9 0 9 0 0 1 0 0 0 0 0 0 0 1 5 0
1 7 7 7 7 7 7 7 1 0 0 0 1 5 0 0 5 1 1 1 1 1 1 1 1 1 1 1 1 1 1 5 9 0 5 1 0 0 0 1 7 7 7 7 7 7 7 1 0 0
1 6 6 6 6 6 6 6 0 0 0 0 1 5 0 0 5 1 0 0 0 0 9 0 9 0 0 0 0 0 1 5 9 0 5 1 0 0 0 0 6 6 6 6 6 6 6 1 0 0
1 0 45 0 48 0 47 0 1 0 0 0 1 5 0 0 5 1 0 0 51 51 51 0 0 51 51 51 0 0 1 5 0 0 5 1 0 0 0 1 0 51 0 48 0 46 0 1 0 0
1 0 45 0 48 0 47 0 1 0 0 0 1 5 0 0 5 1 0 0 51 51 51 0 0 51 51 51 0 0 1 5 0 0 5 1 0 0 0 1 0 50 0 47 0 46 0 1 0 0
1 0 47 0 50 0 45 0 1 0 0 0 1 5 0 0 5 1 0 0 0 0 0 0 0 0 0 0 0 0 1 5 0 0 5 1 0 0 0 1 0 46 0 49 0 51 0 1 0 0
1 0 45 0 48 0 47 0 1 0 0 0 1 5 0 0 5 1 0 0 51 51 51 0 0 51 51 51 0 0 1 5 0 0 5 1 0 0 0 1 0 45 0 45 0 48 0 1 0 0
1 0 45 0 48 0 47 0 1 0 0 0 1 5 0 0 5 1 0 0 51 51 51 0 0 51 51 51 0 0 1 5 0 0 5 1 0 0 0 1 0 46 0 49 0 45 0 1 0 0
1 0 0 0 0 0 0 0 1 0 0 0 1 5 0 0 5 1 0 0 0 0 0 0 0 0 0 0 0 0 1 5 0 0 5 1 0 0 0 1 0 0 0 0 0 0 0 1 0 0
1 7 7 7 7 7 7 7 1 0 0 0 1 1 1 1 1 1 1 1 1 1 1 0 0 1 1 1 1 1 1 1 1 1 1 1 0 0 0 1 7 7 7 7 7 7 7 1 0 0
1 6 6 6 6 6 6 6 0 0 0 0 0 0 0 0 9 0 9 0 9 0 9 0 0 9 0 9 0 0 9 0 0 0 0 0 0 0 0 0 6 6 6 6 6 6 6 1 0 0
1 0 45 0 48 0 47 0 1 0 0 0 0 0 0 0 9 0 9 0 9 0 9 0 0 9 0 9 0 0 9 0 9 0 0 0 0 0 0 1 0 46 0 48 0 47 0 1 0 0
1 0 46 0 49 0 46 0 1 0 0 0 0 0 0 0 9 0 9 0 9 0 9 0 0 9 0 9 0 0 9 0 9 0 0 0 0 0 0 1 0 45 0 48 0 48 0 1 0 0
1 0 47 0 50 0 45 0 1 0 0 0 0 0 0 0 9 0 9 0 9 0 9 0 0 9 0 9 0 0 9 0 9 0 0 0 0 0 0 1 0 45 0 49 0 49 0 1 0 0
1 0 48 0 51 0 48 0 1 0 0 0 0 0 0 0 9 0 9 0 9 0 9 0 0 9 0 9 0 0 9 0 9 0 0 0 0 0 0 1 0 45 0 47 0 47 0 1 0 0
1 0 49 0 50 0 50 0 1 0 0 0 0 0 0 0 9 0 9 0 9 0 9 0 0 9 0 9 0 0 9 0 9 0 0 0 0 0 0 1 0 49 0 47 0 51 0 1 0 0
1 0 0 0 0 0 0 0 1 0 0 0 0 0 0 0 9 0 9 0 9 0 9 0 0 9 0 9 0 0 9 0 9 0 9 0 0 0 0 1 0 0 0 0 0 0 0 1 0 0
3 3 3 3 3 3 3 3 3 3 3 3 3 0 0 0 9 0 9 0 9 0 9 0 0 9 0 9 0 0 9 0 9 0 9 3 3 3 3 3 3 3 3 3 3 3 3 3 0 0
5 5 5 5 5 5 5 5 5 5 5 5 5 5 5 5 5 5 5 5 5 5 5 5 5 5 5 5 5 5 5 5 5 5 5 5 5 5 5 5 5 5 5 5 5 5 5 5 5 5
5 5 5 5 5 5 5 5 5 5 5 5 5 5 5 5 5 5 5 5 5 5 5 5 5 5 5 5 5 5 5 5 5 5 5 5 5 5 5 5 5 5 5 5 5 5 5 5 5 5